11111111111111111111
1000P0000C0000000001
10C00001000001000001
1000000000C000000E01
11111111111111111111
