11111
100C1
10001
1E001
11111
