1111111111111
1P00000C00E01

1111111111111
