11111
1P0X1
10001
1E001
11111
