11111111111111111111111111111111111111111111111111111111111111111111
1E0000000000000C00000C000000000000000000000000000C00000C00P000000001
10100101001000001010010000000101010100101001000001010010000000101011
10100100101010100010010000000101001001001010101000100100000001000001
1P0000000C00C0000000000000000000C0000000C00C0000000000000000000C0001
11111111111111111111111111111111111111111111111111111111111111111111
