1111111111111111111111111111
10P000000C000000C000000C0001
1000000000E000000000C0000001
100000000C0000CCC000001CCC11
1000000100000011100000010001
1111111111111111111111111111
