111111111111111111111111111111111111111111111111111111
10P000000C000000C000000C000000000000000000000000000001
1000000000E000000000C000000000000000000000000000000001
100000000C0000CCC000001CCC1000000000000000000000000001
100000010000001110000001000000000000000000000000000001
100000010000001110000001000000000000000000000000000001
100000010000001110000001000000000000000000000000000001
100000010000001110000001000000000000000000000000000001
100000010000001110000001000000000000000000000000000001
111111111111111111111111111111111111111111111111111111
