1111111111111111111111111
10P000000C000000C000000C1
1000000000E000000000C0001
100000000C0000CCC000001C1
1000000100000011100000011
1000000100000011100000011
1000000100000011100000011
1000000100000011100000011
1000000100000011100000011
1111111111111111111111111
